COUNTY NAME,SCHOOL CODE,SCHOOL,GRADUATE COUNT,COLLEGE BOUND,PCT COLLEGE BOUND,2 OR 4 YEAR COLLEGE OR UNIVERSITY,PCT 2 OR 4 YEAR COLLEGE OR UNIVERSITY,TOTAL POSTSECONDARY BOUND,PCT TOTAL POSTSECONDARY BOUND,NON DEGREE GRANTING POSTSECONDARY SCHOOL,PCT NON DEGREE GRANTING POSTSECONDARY SCHOOL,SPECIALIZED ASSOCIATE DEGREE GRANTING INSTITUTION,PCT SPECIALIZED ASSOCIATE DEGREE GRANTING INSTITUTION
Adams,3,Bermudian Springs HS,148,85,0.574324324,80,0.540540541,85,0.574324324,0,0,5,0.033783784
Adams,17,New Oxford SHS,278,151,0.543165468,151,0.543165468,162,0.582733813,11,0.039568345,0,0
Adams,6269,Fairfield Area HS,72,44,0.611111111,43,0.597222222,44,0.611111111,0,0,1,0.013888889
Adams,6271,Gettysburg Area HS,246,170,0.691056911,164,0.666666667,176,0.715447154,6,0.024390244,6,0.024390244
Adams,14,Littlestown SHS,143,70,0.48951049,70,0.48951049,79,0.552447552,9,0.062937063,0,0
Adams,21,Biglerville HS,102,55,0.539215686,55,0.539215686,60,0.588235294,5,0.049019608,0,0
Allegheny,7727,City CHS,86,62,0.720930233,60,0.697674419,67,0.779069767,5,0.058139535,2,0.023255814
Allegheny,7846,The New Academy CS,19,7,0.368421053,7,0.368421053,9,0.473684211,2,0.105263158,0,0
Allegheny,7562,Urban Pathways 6-12 CS,31,18,0.580645161,17,0.548387097,24,0.774193548,6,0.193548387,1,0.032258065
Allegheny,8308,Passport Academy CS,15,0,0,0,0,0,0,0,0,0,0
Allegheny,409,Pittsburgh Allderdice HS,363,247,0.680440771,244,0.672176309,252,0.694214876,5,0.013774105,3,0.008264463
Allegheny,412,Pittsburgh Carrick HS,118,49,0.415254237,46,0.389830508,62,0.525423729,13,0.110169492,3,0.025423729
Allegheny,416,Pittsburgh Perry HS,89,14,0.157303371,12,0.134831461,14,0.157303371,0,0,2,0.02247191
Allegheny,6047,Pittsburgh Oliver,13,0,0,0,0,0,0,0,0,0,0
Allegheny,6664,Pittsburgh Pioneer,3,0,0,0,0,0,0,0,0,0,0
Allegheny,6811,Pittsburgh Conroy,9,0,0,0,0,1,0.111111111,1,0.111111111,0,0
Allegheny,6915,Pittsburgh Brashear HS,248,2,0.008064516,2,0.008064516,2,0.008064516,0,0,0,0
Allegheny,8105,Pittsburgh Obama 6-12,111,5,0.045045045,5,0.045045045,5,0.045045045,0,0,0,0
Allegheny,8106,Pittsburgh CAPA 6-12,108,95,0.87962963,95,0.87962963,95,0.87962963,0,0,0,0
Allegheny,8107,Pittsburgh Science and Technology Academ,91,68,0.747252747,68,0.747252747,71,0.78021978,3,0.032967033,0,0
Allegheny,8110,Pittsburgh Milliones 6-12,58,4,0.068965517,4,0.068965517,5,0.086206897,1,0.017241379,0,0
Allegheny,8203,Academy at Westinghouse,70,3,0.042857143,2,0.028571429,3,0.042857143,0,0,1,0.014285714
Allegheny,8300,Pittsburgh Online Academy,29,0,0,0,0,0,0,0,0,0,0
Allegheny,7772,Propel CS-Homestead,36,24,0.666666667,24,0.666666667,26,0.722222222,2,0.055555556,0,0
Allegheny,7832,Propel CS-Montour,38,27,0.710526316,27,0.710526316,33,0.868421053,6,0.157894737,0,0
Allegheny,29,Springdale JSHS,63,41,0.650793651,34,0.53968254,41,0.650793651,0,0,7,0.111111111
Allegheny,5199,Avonworth HS,129,102,0.790697674,101,0.782945736,104,0.80620155,2,0.015503876,1,0.007751938
Allegheny,315,Pine-Richland HS,383,327,0.853785901,327,0.853785901,333,0.869451697,6,0.015665796,0,0
Allegheny,50,Baldwin SHS,345,249,0.72173913,249,0.72173913,252,0.730434783,3,0.008695652,0,0
Allegheny,62,Bethel Park HS,349,268,0.767908309,268,0.767908309,268,0.767908309,0,0,0,0
Allegheny,70,Brentwood SHS,90,61,0.677777778,58,0.644444444,63,0.7,2,0.022222222,3,0.033333333
Allegheny,79,Carlynton JSHS,88,47,0.534090909,47,0.534090909,47,0.534090909,0,0,0,0
Allegheny,6706,Chartiers Valley HS,236,171,0.724576271,166,0.703389831,176,0.745762712,5,0.021186441,5,0.021186441
Allegheny,8094,Clairton MS/HS,37,14,0.378378378,11,0.297297297,14,0.378378378,0,0,3,0.081081081
Allegheny,8087,Cornell HS,40,31,0.775,31,0.775,32,0.8,1,0.025,0,0
Allegheny,513,Deer Lakes HS,145,101,0.696551724,101,0.696551724,106,0.731034483,5,0.034482759,0,0
Allegheny,8340,East Allegheny JSHS,93,57,0.612903226,51,0.548387097,58,0.623655914,1,0.010752688,6,0.064516129
Allegheny,144,Elizabeth Forward SHS,144,93,0.645833333,91,0.631944444,97,0.673611111,4,0.027777778,2,0.013888889
Allegheny,7648,Spectrum CS,3,0,0,0,0,0,0,0,0,0,0
Allegheny,156,Fox Chapel Area HS,323,274,0.848297214,274,0.848297214,276,0.854489164,2,0.00619195,0,0
Allegheny,170,Gateway SHS,272,153,0.5625,148,0.544117647,161,0.591911765,8,0.029411765,5,0.018382353
Allegheny,5190,Hampton HS,241,199,0.825726141,199,0.825726141,200,0.829875519,1,0.004149378,0,0
Allegheny,5153,Highlands SHS,182,100,0.549450549,83,0.456043956,106,0.582417582,6,0.032967033,17,0.093406593
Allegheny,5112,Keystone Oaks HS,126,94,0.746031746,93,0.738095238,97,0.76984127,3,0.023809524,1,0.007936508
Allegheny,6105,McKeesport Area SHS,192,113,0.588541667,111,0.578125,119,0.619791667,6,0.03125,2,0.010416667
Allegheny,5017,Montour HS,217,147,0.677419355,146,0.67281106,150,0.69124424,3,0.013824885,1,0.004608295
Allegheny,4951,Moon SHS,280,220,0.785714286,220,0.785714286,232,0.828571429,12,0.042857143,0,0
Allegheny,254,Mt Lebanon SHS,410,388,0.946341463,387,0.943902439,389,0.948780488,1,0.002439024,1,0.002439024
Allegheny,8305,North Allegheny HS,635,577,0.908661417,577,0.908661417,579,0.911811024,2,0.003149606,0,0
Allegheny,53,Northgate MSHS,50,30,0.6,30,0.6,31,0.62,1,0.02,0,0
Allegheny,7101,North Hills SHS,314,232,0.738853503,228,0.72611465,244,0.777070064,12,0.038216561,4,0.012738854
Allegheny,309,Penn Hills SHS,269,73,0.271375465,72,0.267657993,76,0.282527881,3,0.011152416,1,0.003717472
Allegheny,435,Plum SHS,287,197,0.68641115,186,0.648083624,212,0.738675958,15,0.052264808,11,0.038327526
Allegheny,448,Quaker Valley HS,156,117,0.75,116,0.743589744,118,0.756410256,1,0.006410256,1,0.006410256
Allegheny,6928,Riverview JSHS,55,44,0.8,44,0.8,44,0.8,0,0,0,0
Allegheny,460,Shaler Area HS,284,205,0.721830986,197,0.693661972,210,0.73943662,5,0.017605634,8,0.028169014
Allegheny,8392,Westinghouse Arts Academy CS,52,29,0.557692308,24,0.461538462,29,0.557692308,0,0,5,0.096153846
Allegheny,8459,South Allegheny HS,103,51,0.495145631,49,0.475728155,51,0.495145631,0,0,2,0.019417476
Allegheny,470,South Fayette Twp HS,254,224,0.881889764,224,0.881889764,233,0.917322835,9,0.035433071,0,0
Allegheny,467,South Park SHS,141,87,0.617021277,86,0.609929078,87,0.617021277,0,0,1,0.007092199
Allegheny,196,Steel Valley SHS,90,35,0.388888889,35,0.388888889,36,0.4,1,0.011111111,0,0
Allegheny,477,Sto-Rox JSHS,66,33,0.5,29,0.439393939,33,0.5,0,0,4,0.060606061
Allegheny,492,Upper Saint Clair HS,376,342,0.909574468,342,0.909574468,352,0.936170213,10,0.026595745,0,0
Allegheny,509,West Allegheny SHS,251,204,0.812749004,197,0.784860558,204,0.812749004,0,0,7,0.027888446
Allegheny,523,Thomas Jefferson HS,218,156,0.71559633,153,0.701834862,157,0.720183486,1,0.004587156,3,0.013761468
Allegheny,536,West Mifflin Area HS,220,134,0.609090909,131,0.595454545,139,0.631818182,5,0.022727273,3,0.013636364
Allegheny,107,Woodland Hills HS,221,134,0.606334842,134,0.606334842,151,0.683257919,17,0.076923077,0,0
Allegheny,7821,Pennsylvania Distance Learning CS,69,37,0.536231884,36,0.52173913,39,0.565217391,2,0.028985507,1,0.014492754
Allegheny,8129,Propel CS-Braddock Hills,59,37,0.627118644,34,0.576271186,46,0.779661017,9,0.152542373,3,0.050847458
Armstrong,2320,Apollo-Ridge HS,70,42,0.6,40,0.571428571,44,0.628571429,2,0.028571429,2,0.028571429
Armstrong,7640,West Shamokin JSHS,65,0,0,0,0,0,0,0,0,0,0
Armstrong,8342,Armstrong JSHS,202,0,0,0,0,0,0,0,0,0,0
Armstrong,594,Freeport Area SHS,142,117,0.823943662,107,0.753521127,120,0.845070423,3,0.021126761,10,0.070422535
Armstrong,7923,Leechburg Area HS,31,15,0.483870968,14,0.451612903,18,0.580645161,3,0.096774194,1,0.032258065
Armstrong,4807,Lenape Tech,160,58,0.3625,58,0.3625,64,0.4,6,0.0375,0,0
Beaver,7859,Lincoln Park Performing Arts CS,143,0,0,0,0,0,0,0,0,0,0
Beaver,8086,Aliquippa JSHS,61,0,0,0,0,0,0,0,0,0,0
Beaver,6555,Ambridge Area HS,182,123,0.675824176,116,0.637362637,126,0.692307692,3,0.016483516,7,0.038461538
Beaver,640,Beaver Area SHS,162,105,0.648148148,103,0.635802469,108,0.666666667,3,0.018518519,2,0.012345679
Beaver,649,Beaver Falls Area SHS,113,51,0.451327434,51,0.451327434,59,0.522123894,8,0.07079646,0,0
Beaver,6707,Blackhawk HS,180,130,0.722222222,123,0.683333333,135,0.75,5,0.027777778,7,0.038888889
Beaver,8044,Central Valley HS,139,106,0.762589928,102,0.73381295,106,0.762589928,0,0,4,0.028776978
Beaver,6563,Freedom Area SHS,92,55,0.597826087,55,0.597826087,66,0.717391304,11,0.119565217,0,0
Beaver,7650,Pennsylvania Cyber CS,"1,148",463,0.403310105,399,0.347560976,484,0.421602787,21,0.018292683,64,0.055749129
Beaver,675,Hopewell SHS,149,97,0.651006711,91,0.610738255,100,0.67114094,3,0.020134228,6,0.040268456
Beaver,695,New Brighton Area HS,83,44,0.530120482,44,0.530120482,46,0.554216867,2,0.024096386,0,0
Beaver,700,Riverside HS,101,67,0.663366337,65,0.643564356,67,0.663366337,0,0,2,0.01980198
Beaver,8000,Rochester High School,51,27,0.529411765,26,0.509803922,27,0.529411765,0,0,1,0.019607843
Beaver,714,South Side HS,71,46,0.647887324,46,0.647887324,46,0.647887324,0,0,0,0
Beaver,719,Western Beaver Co JSHS,51,22,0.431372549,22,0.431372549,25,0.490196078,3,0.058823529,0,0
Bedford,726,Bedford SHS,141,71,0.503546099,65,0.460992908,72,0.510638298,1,0.007092199,6,0.042553191
Bedford,732,Chestnut Ridge SHS,98,49,0.5,45,0.459183673,49,0.5,0,0,4,0.040816327
Bedford,7897,Everett Area HS,92,40,0.434782609,40,0.434782609,47,0.510869565,7,0.076086957,0,0
Bedford,8436,Northern Bedford County HS,67,33,0.492537313,28,0.417910448,33,0.492537313,0,0,5,0.074626866
Bedford,8154,HOPE for Hyndman CS,19,0,0,0,0,0,0,0,0,0,0
Bedford,753,Tussey Mountain HS,61,29,0.475409836,28,0.459016393,31,0.508196721,2,0.032786885,1,0.016393443
Berks,820,Antietam MS/HS,50,20,0.4,20,0.4,23,0.46,3,0.06,0,0
Berks,6306,Boyertown Area SHS,525,335,0.638095238,334,0.636190476,341,0.64952381,6,0.011428571,1,0.001904762
Berks,6308,Brandywine Heights HS,99,58,0.585858586,55,0.555555556,58,0.585858586,0,0,3,0.03030303
Berks,777,Conrad Weiser HS,196,132,0.673469388,120,0.612244898,137,0.698979592,5,0.025510204,12,0.06122449
Berks,4810,Daniel Boone Area HS,251,165,0.657370518,165,0.657370518,167,0.665338645,2,0.007968127,0,0
Berks,788,Exeter Twp SHS,327,194,0.593272171,191,0.584097859,203,0.620795107,9,0.027522936,3,0.009174312
Berks,5023,Fleetwood SHS,193,119,0.616580311,118,0.611398964,126,0.652849741,7,0.03626943,1,0.005181347
Berks,802,Governor Mifflin SHS,354,205,0.579096045,205,0.579096045,208,0.587570621,3,0.008474576,0,0
Berks,808,Hamburg Area HS,149,81,0.543624161,76,0.510067114,81,0.543624161,0,0,5,0.033557047
Berks,816,Kutztown Area SHS,96,59,0.614583333,59,0.614583333,59,0.614583333,0,0,0,0
Berks,6610,Muhlenberg HS,301,193,0.641196013,181,0.601328904,202,0.671096346,9,0.029900332,12,0.03986711
Berks,6318,Oley Valley SHS,135,93,0.688888889,92,0.681481481,93,0.688888889,0,0,1,0.007407407
Berks,8116,Reading SHS,920,255,0.277173913,254,0.276086957,272,0.295652174,17,0.018478261,1,0.001086957
Berks,864,Schuylkill Valley HS,130,91,0.7,89,0.684615385,95,0.730769231,4,0.030769231,2,0.015384615
Berks,4670,Tulpehocken JSHS,101,37,0.366336634,37,0.366336634,39,0.386138614,2,0.01980198,0,0
Berks,873,Twin Valley HS,238,184,0.773109244,172,0.722689076,187,0.785714286,3,0.012605042,12,0.050420168
Berks,6980,Wilson HS,518,274,0.528957529,274,0.528957529,282,0.544401544,8,0.015444015,0,0
Berks,887,Wyomissing Area JSHS,161,116,0.720496894,116,0.720496894,123,0.763975155,7,0.043478261,0,0
Blair,7720,Central PA Digital Lrng Foundation CS,11,0,0,0,0,0,0,0,0,0,0
Blair,913,Altoona Area HS,502,261,0.519920319,247,0.492031873,300,0.597609562,39,0.077689243,14,0.027888446
Blair,917,Bellwood-Antis HS,95,68,0.715789474,68,0.715789474,68,0.715789474,0,0,0,0
Blair,921,Claysburg-Kimmel HS,76,33,0.434210526,28,0.368421053,37,0.486842105,4,0.052631579,5,0.065789474
Blair,5207,Hollidaysburg Area SHS,264,140,0.53030303,137,0.518939394,162,0.613636364,22,0.083333333,3,0.011363636
Blair,941,Central HS,114,66,0.578947368,63,0.552631579,69,0.605263158,3,0.026315789,3,0.026315789
Blair,949,Tyrone Area HS,132,82,0.621212121,81,0.613636364,87,0.659090909,5,0.037878788,1,0.007575758
Blair,951,Williamsburg Community JSHS,43,19,0.441860465,19,0.441860465,19,0.441860465,0,0,0,0
Bradford,958,Athens Area HS,144,77,0.534722222,76,0.527777778,83,0.576388889,6,0.041666667,1,0.006944444
Bradford,988,Canton JSHS,65,31,0.476923077,31,0.476923077,33,0.507692308,2,0.030769231,0,0
Bradford,964,Northeast Bradford JSHS,45,25,0.555555556,23,0.511111111,25,0.555555556,0,0,2,0.044444444
Bradford,965,Sayre Area HS,71,44,0.61971831,44,0.61971831,45,0.633802817,1,0.014084507,0,0
Bradford,5208,Towanda Area JSHS,103,52,0.504854369,46,0.446601942,56,0.54368932,4,0.038834951,6,0.058252427
Bradford,1000,Troy Area JSHS,93,53,0.569892473,53,0.569892473,57,0.612903226,4,0.043010753,0,0
Bradford,1005,Wyalusing Valley JSHS,84,35,0.416666667,34,0.404761905,37,0.44047619,2,0.023809524,1,0.011904762
Bucks,7726,Center for Student Lrng CS Pennsbury,18,9,0.5,9,0.5,13,0.722222222,4,0.222222222,0,0
Bucks,5116,Bensalem Twp HS,425,281,0.661176471,276,0.649411765,290,0.682352941,9,0.021176471,5,0.011764706
Bucks,1014,Bristol HS,54,25,0.462962963,25,0.462962963,32,0.592592593,7,0.12962963,0,0
Bucks,1029,Truman SHS,323,179,0.554179567,179,0.554179567,193,0.59752322,14,0.043343653,0,0
Bucks,1030,Bucks County Technical High School,294,161,0.547619048,161,0.547619048,179,0.608843537,18,0.06122449,0,0
Bucks,1040,William Tennent HS,405,292,0.720987654,279,0.688888889,293,0.72345679,1,0.002469136,13,0.032098765
Bucks,1043,Central Bucks HS-West,462,393,0.850649351,391,0.846320346,394,0.852813853,1,0.002164502,2,0.004329004
Bucks,5133,Central Bucks HS-East,530,480,0.905660377,480,0.905660377,482,0.909433962,2,0.003773585,0,0
Bucks,7790,Central Bucks HS-South,553,465,0.840867993,463,0.837251356,469,0.848101266,4,0.007233273,2,0.003616637
Bucks,5096,Council Rock HS North,393,352,0.8956743,351,0.893129771,354,0.900763359,2,0.005089059,1,0.002544529
Bucks,7749,Council Rock HS South,483,425,0.879917184,420,0.869565217,429,0.888198758,4,0.008281573,5,0.010351967
Bucks,7568,School Lane CS,59,36,0.610169492,36,0.610169492,38,0.644067797,2,0.033898305,0,0
Bucks,8381,Morrisville HS,55,22,0.4,20,0.363636364,22,0.4,0,0,2,0.036363636
Bucks,6455,Neshaminy HS,604,447,0.740066225,447,0.740066225,471,0.779801325,24,0.039735099,0,0
Bucks,1084,New Hope-Solebury HS,133,124,0.932330827,124,0.932330827,124,0.932330827,0,0,0,0
Bucks,1094,Palisades HS,143,101,0.706293706,101,0.706293706,105,0.734265734,4,0.027972028,0,0
Bucks,1100,Pennridge HS,621,459,0.739130435,457,0.735909823,462,0.743961353,3,0.004830918,2,0.003220612
Bucks,4682,Pennsbury HS,712,583,0.818820225,581,0.816011236,597,0.838483146,14,0.019662921,2,0.002808989
Bucks,1128,Quakertown Community HS,411,289,0.703163017,289,0.703163017,291,0.708029197,2,0.00486618,0,0
Butler,8344,Butler Area SHS,419,304,0.725536993,294,0.701670644,314,0.749403341,10,0.023866348,10,0.023866348
Butler,1154,Karns City HS,75,41,0.546666667,40,0.533333333,48,0.64,7,0.093333333,1,0.013333333
Butler,1159,Mars Area SHS,262,214,0.816793893,214,0.816793893,220,0.839694656,6,0.022900763,0,0
Butler,1164,Moniteau JSHS,99,62,0.626262626,58,0.585858586,62,0.626262626,0,0,4,0.04040404
Butler,1172,Slippery Rock Area HS,154,95,0.616883117,94,0.61038961,100,0.649350649,5,0.032467532,1,0.006493506
Butler,1177,Knoch HS,186,0,0,0,0,0,0,0,0,0,0
Butler,8318,Seneca Valley HS,575,486,0.845217391,486,0.845217391,489,0.850434783,3,0.005217391,0,0
Cambria,5135,Blacklick Valley JSHS,35,27,0.771428571,23,0.657142857,27,0.771428571,0,0,4,0.114285714
Cambria,5212,Cambria Heights SHS,113,73,0.646017699,72,0.637168142,76,0.672566372,3,0.026548673,1,0.008849558
Cambria,1208,Central Cambria HS,114,83,0.728070175,80,0.701754386,85,0.745614035,2,0.01754386,3,0.026315789
Cambria,5136,Conemaugh Valley JSHS,48,26,0.541666667,26,0.541666667,26,0.541666667,0,0,0,0
Cambria,1225,Ferndale Area JSHS,40,0,0,0,0,0,0,0,0,0,0
Cambria,8382,Forest Hills JSHS,117,78,0.666666667,70,0.598290598,79,0.675213675,1,0.008547009,8,0.068376068
Cambria,1251,Greater Johnstown SHS,160,41,0.25625,41,0.25625,51,0.31875,10,0.0625,0,0
Cambria,8314,Greater Johnstown School District's Cybe,2,0,0,0,0,0,0,0,0,0,0
Cambria,6201,Northern Cambria HS,83,50,0.602409639,44,0.530120482,56,0.674698795,6,0.072289157,6,0.072289157
Cambria,1213,Penn Cambria HS,145,72,0.496551724,72,0.496551724,79,0.544827586,7,0.048275862,0,0
Cambria,1270,Portage Area JSHS,55,33,0.6,33,0.6,40,0.727272727,7,0.127272727,0,0
Cambria,7941,Richland HS,118,80,0.677966102,79,0.669491525,83,0.703389831,3,0.025423729,1,0.008474576
Cambria,8379,Westmont Hilltop JSHS,121,91,0.752066116,91,0.752066116,91,0.752066116,0,0,0,0
Cameron,1299,Cameron County JSHS,34,25,0.735294118,25,0.735294118,25,0.735294118,0,0,0,0
Carbon,4870,Carbon Career & Technical Institute,95,27,0.284210526,27,0.284210526,37,0.389473684,10,0.105263158,0,0
Carbon,1307,Jim Thorpe Area HS,115,80,0.695652174,79,0.686956522,84,0.730434783,4,0.034782609,1,0.008695652
Carbon,1315,Lehighton Area HS,192,124,0.645833333,117,0.609375,127,0.661458333,3,0.015625,7,0.036458333
Carbon,4734,Palmerton Area HS,107,74,0.691588785,71,0.663551402,78,0.728971963,4,0.037383178,3,0.028037383
Carbon,8348,Panther Valley JSHS,103,58,0.563106796,58,0.563106796,58,0.563106796,0,0,0,0
Carbon,1327,Weatherly Area SHS,53,33,0.622641509,33,0.622641509,33,0.622641509,0,0,0,0
Centre,1335,Bald Eagle Area JSHS,115,68,0.591304348,60,0.52173913,74,0.643478261,6,0.052173913,8,0.069565217
Centre,1343,Bellefonte Area HS,220,0,0,0,0,0,0,0,0,0,0
Centre,6231,Penns Valley Area JSHS,99,60,0.606060606,60,0.606060606,70,0.707070707,10,0.101010101,0,0
Centre,1364,State College Area HS,564,461,0.817375887,452,0.80141844,461,0.817375887,0,0,9,0.015957447
Chester,7691,21st Century Cyber CS,323,158,0.489164087,157,0.486068111,183,0.566563467,25,0.077399381,1,0.003095975
Chester,7721,Avon Grove CS,66,47,0.712121212,47,0.712121212,49,0.742424242,2,0.03030303,0,0
Chester,7819,Pennsylvania Leadership CS,364,215,0.590659341,198,0.543956044,218,0.598901099,3,0.008241758,17,0.046703297
Chester,1367,Avon Grove HS,408,313,0.767156863,313,0.767156863,323,0.791666667,10,0.024509804,0,0
Chester,5012,Coatesville Area SHS,399,230,0.576441103,205,0.513784461,250,0.626566416,20,0.050125313,25,0.062656642
Chester,1387,Downingtown HS West Campus,415,345,0.831325301,342,0.824096386,354,0.853012048,9,0.021686747,3,0.007228916
Chester,7759,Downingtown HS East Campus,449,372,0.828507795,371,0.826280624,382,0.85077951,10,0.022271715,1,0.002227171
Chester,8174,Downingtown STEM Academy,204,202,0.990196078,202,0.990196078,202,0.990196078,0,0,0,0
Chester,8394,Insight PA Cyber CS,212,0,0,0,0,0,0,0,0,0,0
Chester,7628,Collegium CS,111,81,0.72972973,79,0.711711712,86,0.774774775,5,0.045045045,2,0.018018018
Chester,7636,Renaissance Academy CS,73,61,0.835616438,60,0.821917808,62,0.849315068,1,0.01369863,1,0.01369863
Chester,1424,Great Valley HS,332,306,0.921686747,306,0.921686747,307,0.924698795,1,0.003012048,0,0
Chester,6482,Kennett HS,316,229,0.724683544,229,0.724683544,239,0.756329114,10,0.03164557,0,0
Chester,1414,Octorara Area JSHS,177,108,0.610169492,101,0.570621469,110,0.621468927,2,0.011299435,7,0.039548023
Chester,1406,Owen J Roberts HS,375,285,0.76,285,0.76,288,0.768,3,0.008,0,0
Chester,1420,Oxford Area HS,303,187,0.617161716,173,0.570957096,191,0.630363036,4,0.01320132,14,0.04620462
Chester,1426,Phoenixville Area HS,291,223,0.766323024,223,0.766323024,229,0.786941581,6,0.020618557,0,0
Chester,1423,Conestoga SHS,539,526,0.975881262,526,0.975881262,531,0.985157699,5,0.009276438,0,0
Chester,1443,Unionville HS,333,294,0.882882883,293,0.87987988,296,0.888888889,2,0.006006006,1,0.003003003
Chester,1453,West Chester Henderson HS,320,268,0.8375,266,0.83125,273,0.853125,5,0.015625,2,0.00625
Chester,6734,West Chester East HS,322,273,0.847826087,266,0.826086957,276,0.857142857,3,0.00931677,7,0.02173913
Chester,7894,West Chester Bayard Rustin HS,339,309,0.911504425,304,0.896755162,312,0.920353982,3,0.008849558,5,0.014749263
Chester,7824,Achievement House CS,158,67,0.424050633,61,0.386075949,73,0.462025316,6,0.037974684,6,0.037974684
Clarion,4664,Allegheny-Clarion Valley HS,44,26,0.590909091,24,0.545454545,26,0.590909091,0,0,2,0.045454545
Clarion,1475,Clarion Area JSHS,65,37,0.569230769,36,0.553846154,37,0.569230769,0,0,1,0.015384615
Clarion,1480,Clarion-Limestone Area JSHS,59,39,0.661016949,36,0.610169492,40,0.677966102,1,0.016949153,3,0.050847458
Clarion,1486,Keystone JSHS,84,45,0.535714286,43,0.511904762,48,0.571428571,3,0.035714286,2,0.023809524
Clarion,1489,North Clarion Co JSHS,36,19,0.527777778,19,0.527777778,19,0.527777778,0,0,0,0
Clarion,1495,Redbank Valley HS,85,55,0.647058824,55,0.647058824,55,0.647058824,0,0,0,0
Clarion,1501,Union HS,38,12,0.315789474,12,0.315789474,16,0.421052632,4,0.105263158,0,0
Clearfield,6156,DuBois Area SHS,259,159,0.613899614,159,0.613899614,172,0.664092664,13,0.05019305,0,0
Clearfield,6236,Clearfield Area JSHS,154,63,0.409090909,61,0.396103896,65,0.422077922,2,0.012987013,2,0.012987013
Clearfield,1529,Curwensville Area JSHS,71,43,0.605633803,40,0.563380282,43,0.605633803,0,0,3,0.042253521
Clearfield,5219,Glendale JSHS,60,44,0.733333333,43,0.716666667,47,0.783333333,3,0.05,1,0.016666667
Clearfield,8316,Harmony Area JSHS,23,14,0.608695652,14,0.608695652,14,0.608695652,0,0,0,0
Clearfield,1550,Moshannon Valley JSHS,52,26,0.5,25,0.480769231,30,0.576923077,4,0.076923077,1,0.019230769
Clearfield,1560,Philipsburg-Osceola Area HS,118,53,0.449152542,53,0.449152542,53,0.449152542,0,0,0,0
Clearfield,1566,West Branch Area HS,64,30,0.46875,22,0.34375,30,0.46875,0,0,8,0.125
Clinton,7635,Sugar Valley Rural CS,33,14,0.424242424,14,0.424242424,17,0.515151515,3,0.090909091,0,0
Clinton,6241,Bucktail HS,27,22,0.814814815,18,0.666666667,22,0.814814815,0,0,4,0.148148148
Clinton,7589,Central Mountain HS,275,128,0.465454545,117,0.425454545,128,0.465454545,0,0,11,0.04
Columbia,8434,Benton Area HS,38,17,0.447368421,17,0.447368421,19,0.5,2,0.052631579,0,0
Columbia,1605,Berwick Area HS,198,112,0.565656566,110,0.555555556,114,0.575757576,2,0.01010101,2,0.01010101
Columbia,1612,Bloomsburg Area HS,115,73,0.634782609,72,0.626086957,75,0.652173913,2,0.017391304,1,0.008695652
Columbia,1619,Central Columbia SHS,140,107,0.764285714,102,0.728571429,109,0.778571429,2,0.014285714,5,0.035714286
Columbia,5178,Columbia-Montour AVTS,132,28,0.212121212,27,0.204545455,32,0.242424242,4,0.03030303,1,0.007575758
Columbia,1623,Millville Area JSHS,52,30,0.576923077,30,0.576923077,30,0.576923077,0,0,0,0
Columbia,1627,Southern Columbia HS,85,62,0.729411765,62,0.729411765,62,0.729411765,0,0,0,0
Columbia,7567,Susq-Cyber CS,30,15,0.5,14,0.466666667,24,0.8,9,0.3,1,0.033333333
Crawford,8224,Conneaut Area Senior High,145,58,0.4,58,0.4,67,0.462068966,9,0.062068966,0,0
Crawford,1632,Cochranton JSHS,57,22,0.385964912,22,0.385964912,22,0.385964912,0,0,0,0
Crawford,1654,Meadville Area SHS,190,106,0.557894737,96,0.505263158,108,0.568421053,2,0.010526316,10,0.052631579
Crawford,1629,Cambridge Springs JSHS,71,26,0.366197183,24,0.338028169,28,0.394366197,2,0.028169014,2,0.028169014
Crawford,6136,Saegertown JSHS,46,25,0.543478261,23,0.5,26,0.565217391,1,0.02173913,2,0.043478261
Crawford,6942,Maplewood JSHS,58,32,0.551724138,30,0.517241379,35,0.603448276,3,0.051724138,2,0.034482759
Cumberland,1677,Big Spring HS,168,82,0.488095238,82,0.488095238,82,0.488095238,0,0,0,0
Cumberland,1682,Camp Hill SHS,103,78,0.757281553,78,0.757281553,79,0.766990291,1,0.009708738,0,0
Cumberland,1694,Carlisle Area HS,347,222,0.639769452,217,0.625360231,225,0.648414986,3,0.008645533,5,0.014409222
Cumberland,1701,Cumberland Valley HS,631,496,0.786053883,491,0.778129952,499,0.790808241,3,0.004754358,5,0.00792393
Cumberland,1707,East Pennsboro Area SHS,191,105,0.54973822,105,0.54973822,110,0.57591623,5,0.02617801,0,0
Cumberland,5098,Mechanicsburg Area SHS,291,201,0.690721649,195,0.670103093,201,0.690721649,0,0,6,0.020618557
Cumberland,5221,Shippensburg Area SHS,250,123,0.492,123,0.492,125,0.5,2,0.008,0,0
Cumberland,6328,Boiling Springs HS,155,91,0.587096774,90,0.580645161,91,0.587096774,0,0,1,0.006451613
Dauphin,7774,Commonwealth Charter Academy CS,"1,060",398,0.375471698,395,0.372641509,505,0.476415094,107,0.100943396,3,0.002830189
Dauphin,1745,Central Dauphin SHS,442,319,0.721719457,310,0.701357466,328,0.742081448,9,0.020361991,9,0.020361991
Dauphin,1746,Central Dauphin East SHS,320,123,0.384375,122,0.38125,124,0.3875,1,0.003125,1,0.003125
Dauphin,5278,Dauphin County Technical School,225,113,0.502222222,113,0.502222222,116,0.515555556,3,0.013333333,0,0
Dauphin,4801,Hershey HS,320,271,0.846875,269,0.840625,272,0.85,1,0.003125,2,0.00625
Dauphin,6330,Halifax Area HS,66,34,0.515151515,34,0.515151515,35,0.53030303,1,0.015151515,0,0
Dauphin,6333,Harrisburg HS,163,59,0.36196319,59,0.36196319,63,0.386503067,4,0.024539877,0,0
Dauphin,7902,Harrisburg HS - SciTech Cmp,81,81,1,81,1,81,1,0,0,0,0
Dauphin,8376,Cougar Academy,12,6,0.5,6,0.5,6,0.5,0,0,0,0
Dauphin,1776,Lower Dauphin HS,274,201,0.733576642,199,0.726277372,210,0.766423358,9,0.032846715,2,0.00729927
Dauphin,7844,Price,3,0,0,0,0,0,0,0,0,0,0
Dauphin,1790,Middletown Area HS,124,62,0.5,58,0.467741935,66,0.532258065,4,0.032258065,4,0.032258065
Dauphin,1794,Millersburg Area SHS,55,41,0.745454545,40,0.727272727,41,0.745454545,0,0,1,0.018181818
Dauphin,8278,Capital Area School for the Arts CS,50,34,0.68,34,0.68,34,0.68,0,0,0,0
Dauphin,8366,Reach Cyber CS,627,287,0.457735247,287,0.457735247,353,0.562998405,66,0.105263158,0,0
Dauphin,1801,Steelton-Highspire HS,49,28,0.571428571,28,0.571428571,33,0.673469388,5,0.102040816,0,0
Dauphin,1806,Susquehanna Twp HS,165,109,0.660606061,104,0.63030303,113,0.684848485,4,0.024242424,5,0.03030303
Dauphin,6340,Upper Dauphin Area HS,81,36,0.444444444,34,0.419753086,37,0.456790123,1,0.012345679,2,0.024691358
Delaware,6492,Chester HS,126,25,0.198412698,25,0.198412698,31,0.246031746,6,0.047619048,0,0
Delaware,8303,STEM at Showalter,87,55,0.632183908,55,0.632183908,58,0.666666667,3,0.034482759,0,0
Delaware,1849,Chichester SHS,210,109,0.519047619,101,0.480952381,121,0.576190476,12,0.057142857,8,0.038095238
Delaware,1869,Garnet Valley HS,405,359,0.886419753,359,0.886419753,361,0.891358025,2,0.004938272,0,0
Delaware,1879,Haverford SHS,1,0,0,0,0,0,0,0,0,0,0
Delaware,1885,Interboro SHS,283,175,0.618374558,168,0.593639576,182,0.643109541,7,0.024734982,7,0.024734982
Delaware,1902,Marple Newtown SHS,247,197,0.79757085,195,0.789473684,201,0.813765182,4,0.016194332,2,0.008097166
Delaware,8258,Chester Charter Scholars Academy CS,46,32,0.695652174,32,0.695652174,38,0.826086957,6,0.130434783,0,0
Delaware,1915,Sun Valley HS,254,180,0.708661417,180,0.708661417,184,0.724409449,4,0.015748031,0,0
Delaware,1921,Radnor SHS,307,268,0.872964169,268,0.872964169,275,0.895765472,7,0.022801303,0,0
Delaware,1934,Ridley HS,408,295,0.723039216,260,0.637254902,312,0.764705882,17,0.041666667,35,0.085784314
Delaware,1942,Penncrest HS,280,246,0.878571429,246,0.878571429,246,0.878571429,0,0,0,0
Delaware,6516,Academy Park HS,303,0,0,0,0,0,0,0,0,0,0
Delaware,1950,Springfield HS,307,245,0.798045603,245,0.798045603,253,0.824104235,8,0.026058632,0,0
Delaware,1972,Upper Darby SHS,867,498,0.574394464,498,0.574394464,498,0.574394464,0,0,0,0
Delaware,5287,Strath Haven HS,307,272,0.885993485,271,0.882736156,272,0.885993485,0,0,1,0.003257329
Delaware,8231,Penn Wood HS,314,200,0.636942675,194,0.617834395,200,0.636942675,0,0,6,0.01910828
Elk,6218,Johnsonburg Area HS,30,21,0.7,21,0.7,21,0.7,0,0,0,0
Elk,1989,Ridgway Area HS,50,28,0.56,28,0.56,30,0.6,2,0.04,0,0
Elk,5169,St Marys Area SHS,162,89,0.549382716,89,0.549382716,110,0.679012346,21,0.12962963,0,0
Erie,7770,Perseus House CS of Excellence,52,23,0.442307692,21,0.403846154,28,0.538461538,5,0.096153846,2,0.038461538
Erie,1998,Corry Area HS,143,49,0.342657343,47,0.328671329,59,0.412587413,10,0.06993007,2,0.013986014
Erie,7515,Northwest PA Collegiate Academy,190,165,0.868421053,163,0.857894737,166,0.873684211,1,0.005263158,2,0.010526316
Erie,8417,Erie HS,443,75,0.169300226,74,0.167042889,76,0.171557562,1,0.002257336,1,0.002257336
Erie,6737,Fairview HS,120,87,0.725,87,0.725,91,0.758333333,4,0.033333333,0,0
Erie,2037,Fort LeBoeuf SHS,152,92,0.605263158,90,0.592105263,100,0.657894737,8,0.052631579,2,0.013157895
Erie,2040,General McLane HS,161,101,0.627329193,100,0.621118012,101,0.627329193,0,0,1,0.00621118
Erie,2043,Girard HS,121,54,0.446280992,54,0.446280992,54,0.446280992,0,0,0,0
Erie,7948,Harbor Creek Senior HS,165,105,0.636363636,105,0.636363636,106,0.642424242,1,0.006060606,0,0
Erie,4817,Iroquois JSHS,74,37,0.5,34,0.459459459,37,0.5,0,0,3,0.040540541
Erie,8071,McDowell HS,519,321,0.61849711,314,0.605009634,331,0.637764933,10,0.019267823,7,0.013487476
Erie,6145,North East HS,125,59,0.472,59,0.472,61,0.488,2,0.016,0,0
Erie,6745,Northwestern SHS,92,46,0.5,41,0.445652174,48,0.52173913,2,0.02173913,5,0.054347826
Erie,2075,Union City HS,73,29,0.397260274,29,0.397260274,29,0.397260274,0,0,0,0
Erie,6148,Seneca HS,85,29,0.341176471,29,0.341176471,31,0.364705882,2,0.023529412,0,0
Fayette,6001,Albert Gallatin Area SHS,234,106,0.452991453,106,0.452991453,129,0.551282051,23,0.098290598,0,0
Fayette,4818,Brownsville Area HS,88,64,0.727272727,52,0.590909091,64,0.727272727,0,0,12,0.136363636
Fayette,5228,Connellsville Area SHS,214,111,0.518691589,107,0.5,115,0.537383178,4,0.018691589,4,0.018691589
Fayette,2126,Frazier HS,92,65,0.706521739,64,0.695652174,66,0.717391304,1,0.010869565,1,0.010869565
Fayette,6600,Laurel Highlands SHS,211,112,0.530805687,103,0.488151659,118,0.559241706,6,0.028436019,9,0.042654028
Fayette,6643,Connellsville Area Career & Technical Ce,97,21,0.216494845,14,0.144329897,24,0.24742268,3,0.030927835,7,0.072164948
Fayette,2184,Uniontown Area SHS,134,83,0.619402985,75,0.559701493,88,0.656716418,5,0.037313433,8,0.059701493
Forest,6159,East Forest JSHS,13,6,0.461538462,6,0.461538462,6,0.461538462,0,0,0,0
Forest,6161,West Forest JSHS,17,7,0.411764706,4,0.235294118,7,0.411764706,0,0,3,0.176470588
Franklin,2191,Chambersburg Area SHS,391,93,0.237851662,88,0.225063939,97,0.248081841,4,0.010230179,5,0.012787724
Franklin,8244,Chambersburg Area Career Magnet Sch,206,69,0.334951456,68,0.330097087,69,0.334951456,0,0,1,0.004854369
Franklin,2201,Fannett-Metal SHS,38,14,0.368421053,14,0.368421053,17,0.447368421,3,0.078947368,0,0
Franklin,2206,Greencastle-Antrim SHS,215,128,0.595348837,124,0.576744186,134,0.623255814,6,0.027906977,4,0.018604651
Franklin,6280,James Buchanan HS,145,53,0.365517241,50,0.344827586,57,0.393103448,4,0.027586207,3,0.020689655
Franklin,2243,Waynesboro Area SHS,266,126,0.473684211,126,0.473684211,132,0.496240602,6,0.022556391,0,0
Fulton,6252,McConnellsburg HS,52,23,0.442307692,22,0.423076923,27,0.519230769,4,0.076923077,1,0.019230769
Fulton,2246,Forbes Road JSHS,22,11,0.5,9,0.409090909,11,0.5,0,0,2,0.090909091
Fulton,2253,Southern Fulton JSHS,47,26,0.553191489,26,0.553191489,26,0.553191489,0,0,0,0
Greene,7112,Carmichaels Area HS,83,53,0.638554217,45,0.542168675,53,0.638554217,0,0,8,0.096385542
Greene,5118,Waynesburg Central HS,108,58,0.537037037,54,0.5,60,0.555555556,2,0.018518519,4,0.037037037
Greene,2280,Jefferson-Morgan MS/HS,53,19,0.358490566,19,0.358490566,20,0.377358491,1,0.018867925,0,0
Greene,2284,Mapletown JSHS,41,14,0.341463415,14,0.341463415,14,0.341463415,0,0,0,0
Greene,8442,West Greene JSHS,44,17,0.386363636,17,0.386363636,17,0.386363636,0,0,0,0
Huntingdon,2305,Huntingdon Area SHS,122,63,0.516393443,55,0.450819672,67,0.549180328,4,0.032786885,8,0.06557377
Huntingdon,2308,Juniata Valley JSHS,70,33,0.471428571,32,0.457142857,33,0.471428571,0,0,1,0.014285714
Huntingdon,7944,Mount Union Area SHS,82,31,0.37804878,30,0.365853659,38,0.463414634,7,0.085365854,1,0.012195122
Huntingdon,2313,Southern Huntingdon Co HS/MS,85,36,0.423529412,33,0.388235294,38,0.447058824,2,0.023529412,3,0.035294118
Huntingdon,7762,New Day CS,21,6,0.285714286,6,0.285714286,6,0.285714286,0,0,0,0
Indiana,2353,Saltsburg MS/HS,41,25,0.609756098,25,0.609756098,25,0.609756098,0,0,0,0
Indiana,4706,Blairsville SHS,69,32,0.463768116,32,0.463768116,33,0.47826087,1,0.014492754,0,0
Indiana,2331,Homer-Center JSHS,77,38,0.493506494,38,0.493506494,41,0.532467532,3,0.038961039,0,0
Indiana,2325,Indiana Area SHS,186,121,0.650537634,121,0.650537634,122,0.655913978,1,0.005376344,0,0
Indiana,2339,Marion Center Area JR/SR HS,103,56,0.54368932,51,0.495145631,59,0.572815534,3,0.029126214,5,0.048543689
Indiana,2345,Penns Manor Area JSHS,62,40,0.64516129,40,0.64516129,41,0.661290323,1,0.016129032,0,0
Indiana,2350,Purchase Line JSHS,44,22,0.5,20,0.454545455,26,0.590909091,4,0.090909091,2,0.045454545
Indiana,2358,United JSHS,88,57,0.647727273,57,0.647727273,61,0.693181818,4,0.045454545,0,0
Jefferson,2362,Brockway Area JSHS,72,50,0.694444444,47,0.652777778,50,0.694444444,0,0,3,0.041666667
Jefferson,6162,Brookville JSHS,95,54,0.568421053,52,0.547368421,54,0.568421053,0,0,2,0.021052632
Jefferson,5180,Jefferson County-DuBois AVTS,84,14,0.166666667,14,0.166666667,16,0.19047619,2,0.023809524,0,0
Jefferson,6165,Punxsutawney Area HS,131,73,0.557251908,72,0.549618321,77,0.58778626,4,0.030534351,1,0.007633588
Juniata,2394,East Juniata JSHS,77,36,0.467532468,36,0.467532468,37,0.480519481,1,0.012987013,0,0
Juniata,6255,Juniata SHS,138,31,0.224637681,31,0.224637681,33,0.239130435,2,0.014492754,0,0
Lackawanna,5091,Abington Heights HS,254,251,0.988188976,251,0.988188976,251,0.988188976,0,0,0,0
Lackawanna,2420,Carbondale Area JSHS,94,66,0.70212766,66,0.70212766,68,0.723404255,2,0.021276596,0,0
Lackawanna,8312,Dunmore JSHS,120,81,0.675,81,0.675,93,0.775,12,0.1,0,0
Lackawanna,6404,Lakeland JSHS,113,79,0.699115044,78,0.690265487,82,0.725663717,3,0.026548673,1,0.008849558
Lackawanna,8304,Mid Valley Secondary Center,119,54,0.453781513,54,0.453781513,54,0.453781513,0,0,0,0
Lackawanna,2446,North Pocono HS,218,144,0.660550459,144,0.660550459,147,0.674311927,3,0.013761468,0,0
Lackawanna,2449,Old Forge JSHS,78,53,0.679487179,53,0.679487179,53,0.679487179,0,0,0,0
Lackawanna,2496,Riverside JSHS,90,61,0.677777778,61,0.677777778,61,0.677777778,0,0,0,0
Lackawanna,2489,West Scranton HS,219,121,0.552511416,121,0.552511416,135,0.616438356,14,0.063926941,0,0
Lackawanna,6413,Scranton HS,374,215,0.57486631,214,0.572192513,226,0.604278075,11,0.029411765,1,0.002673797
Lackawanna,6775,Valley View HS,157,115,0.732484076,114,0.72611465,116,0.738853503,1,0.006369427,1,0.006369427
Lancaster,6290,Cocalico SHS,221,127,0.574660633,123,0.556561086,134,0.606334842,7,0.031674208,4,0.018099548
Lancaster,2515,Columbia HS,64,29,0.453125,29,0.453125,29,0.453125,0,0,0,0
Lancaster,2532,Conestoga Valley SHS,296,168,0.567567568,165,0.557432432,168,0.567567568,0,0,3,0.010135135
Lancaster,2539,Donegal HS,205,137,0.668292683,133,0.648780488,141,0.687804878,4,0.019512195,4,0.019512195
Lancaster,2554,Garden Spot SHS,242,110,0.454545455,107,0.44214876,116,0.479338843,6,0.024793388,3,0.012396694
Lancaster,2562,Elizabethtown Area SHS,298,168,0.563758389,168,0.563758389,187,0.627516779,19,0.063758389,0,0
Lancaster,6293,Ephrata SHS,322,166,0.51552795,152,0.472049689,168,0.52173913,2,0.00621118,14,0.043478261
Lancaster,7538,La Academia Partnership CS,20,17,0.85,17,0.85,17,0.85,0,0,0,0
Lancaster,2578,Hempfield SHS,503,364,0.723658052,333,0.662027833,365,0.725646123,1,0.001988072,31,0.061630219
Lancaster,2607,Lampeter-Strasburg SHS,231,173,0.748917749,172,0.744588745,179,0.774891775,6,0.025974026,1,0.004329004
Lancaster,2596,McCaskey Campus,514,307,0.597276265,262,0.509727626,323,0.628404669,16,0.031128405,45,0.087548638
Lancaster,7922,Phoenix Academy,82,10,0.12195122,9,0.109756098,11,0.134146341,1,0.012195122,1,0.012195122
Lancaster,2618,Manheim Central SHS,205,113,0.551219512,106,0.517073171,116,0.565853659,3,0.014634146,7,0.034146341
Lancaster,2623,Manheim Twp HS,439,351,0.799544419,341,0.776765376,361,0.822323462,10,0.022779043,10,0.022779043
Lancaster,2633,Penn Manor HS,363,218,0.600550964,204,0.561983471,228,0.628099174,10,0.027548209,14,0.038567493
Lancaster,2649,Pequea Valley HS,127,57,0.448818898,56,0.440944882,62,0.488188976,5,0.039370079,1,0.007874016
Lancaster,2658,Solanco HS,239,90,0.376569038,83,0.347280335,90,0.376569038,0,0,7,0.029288703
Lancaster,2663,Warwick SHS,342,170,0.497076023,155,0.453216374,174,0.50877193,4,0.011695906,15,0.043859649
Lawrence,2675,Lincoln JSHS,130,78,0.6,78,0.6,92,0.707692308,14,0.107692308,0,0
Lawrence,2680,Laurel HS,98,59,0.602040816,59,0.602040816,66,0.673469388,7,0.071428571,0,0
Lawrence,4940,Lawrence County CTC,109,16,0.146788991,16,0.146788991,16,0.146788991,0,0,0,0
Lawrence,2686,Mohawk SHS,105,62,0.59047619,57,0.542857143,74,0.704761905,12,0.114285714,5,0.047619048
Lawrence,2689,Neshannock JSHS,100,64,0.64,63,0.63,68,0.68,4,0.04,1,0.01
Lawrence,2704,New Castle SHS,153,66,0.431372549,61,0.39869281,67,0.437908497,1,0.006535948,5,0.032679739
Lawrence,2708,Shenango HS,75,58,0.773333333,58,0.773333333,61,0.813333333,3,0.04,0,0
Lawrence,2712,Union Area HS,44,30,0.681818182,28,0.636363636,31,0.704545455,1,0.022727273,2,0.045454545
Lawrence,2721,Wilmington Area HS,94,78,0.829787234,69,0.734042553,78,0.829787234,0,0,9,0.095744681
Lebanon,2725,Annville Cleona HS,102,63,0.617647059,63,0.617647059,64,0.62745098,1,0.009803922,0,0
Lebanon,4800,Cedar Crest HS,361,187,0.51800554,187,0.51800554,211,0.584487535,24,0.066481994,0,0
Lebanon,2740,Eastern Lebanon Co SHS,167,96,0.574850299,96,0.574850299,96,0.574850299,0,0,0,0
Lebanon,5155,Lebanon SHS,276,111,0.402173913,104,0.376811594,116,0.420289855,5,0.018115942,7,0.025362319
Lebanon,2760,Northern Lebanon SHS,142,56,0.394366197,56,0.394366197,57,0.401408451,1,0.007042254,0,0
Lebanon,2766,Palmyra Area SHS,264,178,0.674242424,177,0.670454545,179,0.678030303,1,0.003787879,1,0.003787879
Lehigh,2794,William Allen HS,493,228,0.462474645,216,0.438133874,245,0.496957404,17,0.034482759,12,0.024340771
Lehigh,2795,Louis E Dieruff HS,404,215,0.532178218,208,0.514851485,234,0.579207921,19,0.047029703,7,0.017326733
Lehigh,8412,Building 21 Allentown,78,37,0.474358974,36,0.461538462,43,0.551282051,6,0.076923077,1,0.012820513
Lehigh,2798,Catasauqua SHS,103,66,0.640776699,64,0.621359223,67,0.650485437,1,0.009708738,2,0.019417476
Lehigh,2809,Emmaus HS,721,560,0.776699029,555,0.769764216,565,0.783633842,5,0.006934813,5,0.006934813
Lehigh,8401,Roberto Clemente CS,41,18,0.43902439,18,0.43902439,23,0.56097561,5,0.12195122,0,0
Lehigh,2818,Northern Lehigh SHS,117,71,0.606837607,68,0.581196581,74,0.632478632,3,0.025641026,3,0.025641026
Lehigh,2821,Northwestern Lehigh HS,173,124,0.716763006,124,0.716763006,125,0.722543353,1,0.005780347,0,0
Lehigh,2829,Parkland HS,765,615,0.803921569,615,0.803921569,634,0.82875817,19,0.024836601,0,0
Lehigh,8371,Innovative Arts Academy CS,44,19,0.431818182,18,0.409090909,23,0.522727273,4,0.090909091,1,0.022727273
Lehigh,2833,Salisbury SHS,129,96,0.744186047,93,0.720930233,97,0.751937984,1,0.007751938,3,0.023255814
Lehigh,2839,Southern Lehigh SHS,244,147,0.602459016,147,0.602459016,147,0.602459016,0,0,0,0
Lehigh,2848,Whitehall HS,327,156,0.47706422,153,0.467889908,156,0.47706422,0,0,3,0.009174312
Lehigh,8325,Executive Education Academy CS,78,52,0.666666667,47,0.602564103,57,0.730769231,5,0.064102564,5,0.064102564
Lehigh,8125,Lincoln Leadership Academy CS,41,37,0.902439024,37,0.902439024,37,0.902439024,0,0,0,0
Luzerne,8446,Crestwood Secondary Campus,220,147,0.668181818,142,0.645454545,149,0.677272727,2,0.009090909,5,0.022727273
Luzerne,2869,Dallas SHS,201,147,0.731343284,147,0.731343284,147,0.731343284,0,0,0,0
Luzerne,5242,Greater Nanticoke Area SHS,157,81,0.515923567,81,0.515923567,86,0.547770701,5,0.031847134,0,0
Luzerne,2891,Hanover Area JSHS,132,50,0.378787879,49,0.371212121,52,0.393939394,2,0.015151515,1,0.007575758
Luzerne,7348,Hazleton Area HS,714,341,0.477591036,339,0.474789916,346,0.484593838,5,0.007002801,2,0.00280112
Luzerne,2924,Lake-Lehman JSHS,145,107,0.737931034,106,0.731034483,108,0.744827586,1,0.006896552,1,0.006896552
Luzerne,2958,Northwest Area HS,81,51,0.62962963,51,0.62962963,52,0.641975309,1,0.012345679,0,0
Luzerne,5058,Pittston Area SHS,228,161,0.706140351,160,0.701754386,170,0.745614035,9,0.039473684,1,0.004385965
Luzerne,5059,West Side CTC,102,31,0.303921569,31,0.303921569,37,0.362745098,6,0.058823529,0,0
Luzerne,3007,James M Coughlin JSHS,202,88,0.435643564,88,0.435643564,89,0.440594059,1,0.004950495,0,0
Luzerne,3008,G A R Memorial JSHS,127,59,0.464566929,59,0.464566929,65,0.511811024,6,0.047244094,0,0
Luzerne,3009,Elmer L Meyers JSHS,109,65,0.596330275,60,0.550458716,67,0.614678899,2,0.018348624,5,0.04587156
Luzerne,6390,Wyoming Area Sec Ctr,146,95,0.650684932,94,0.643835616,95,0.650684932,0,0,1,0.006849315
Luzerne,6391,Wyoming Valley West SHS,281,149,0.53024911,148,0.526690391,149,0.53024911,0,0,1,0.003558719
Lycoming,6364,Hughesville JSHS,117,67,0.572649573,67,0.572649573,71,0.606837607,4,0.034188034,0,0
Lycoming,3034,Jersey Shore Area SHS,145,75,0.517241379,72,0.496551724,75,0.517241379,0,0,3,0.020689655
Lycoming,4828,Loyalsock Twp SHS,104,71,0.682692308,71,0.682692308,73,0.701923077,2,0.019230769,0,0
Lycoming,3040,Montgomery JSHS,58,34,0.586206897,31,0.534482759,34,0.586206897,0,0,3,0.051724138
Lycoming,3045,Montoursville Area SHS,145,105,0.724137931,98,0.675862069,109,0.751724138,4,0.027586207,7,0.048275862
Lycoming,3048,Muncy JSHS,66,39,0.590909091,39,0.590909091,39,0.590909091,0,0,0,0
Lycoming,3056,South Williamsport Area JSHS,81,41,0.50617284,41,0.50617284,42,0.518518519,1,0.012345679,0,0
Lycoming,6368,Williamsport Area SHS,294,194,0.659863946,194,0.659863946,194,0.659863946,0,0,0,0
McKean,4691,Bradford Area HS,164,94,0.573170732,92,0.56097561,96,0.585365854,2,0.012195122,2,0.012195122
McKean,5245,Kane Area HS,98,60,0.612244898,60,0.612244898,60,0.612244898,0,0,0,0
McKean,3107,Otto-Eldred JSHS,51,31,0.607843137,31,0.607843137,32,0.62745098,1,0.019607843,0,0
McKean,3111,Port Allegany JSHS,57,19,0.333333333,17,0.298245614,21,0.368421053,2,0.035087719,2,0.035087719
McKean,3117,Smethport Area JSHS,49,0,0,0,0,0,0,0,0,0,0
Mercer,6122,Commodore Perry JSHS,38,17,0.447368421,14,0.368421053,17,0.447368421,0,0,3,0.078947368
Mercer,5248,Farrell Area HS/UMS,46,23,0.5,20,0.434782609,30,0.652173913,7,0.152173913,3,0.065217391
Mercer,3137,Greenville JSHS,84,62,0.738095238,57,0.678571429,64,0.761904762,2,0.023809524,5,0.05952381
Mercer,7506,Keystone Education Center CS,43,9,0.209302326,9,0.209302326,9,0.209302326,0,0,0,0
Mercer,3145,Grove City Area HS,144,83,0.576388889,79,0.548611111,89,0.618055556,6,0.041666667,4,0.027777778
Mercer,6125,Grove City Area George Jr HS,13,5,0.384615385,5,0.384615385,6,0.461538462,1,0.076923077,0,0
Mercer,3150,Hickory HS,149,113,0.758389262,105,0.704697987,115,0.771812081,2,0.013422819,8,0.053691275
Mercer,6126,Jamestown Area JSHS,30,19,0.633333333,15,0.5,19,0.633333333,0,0,4,0.133333333
Mercer,8481,Lakeview Middle-HS,80,42,0.525,42,0.525,43,0.5375,1,0.0125,0,0
Mercer,3158,Mercer Area SHS,70,40,0.571428571,40,0.571428571,43,0.614285714,3,0.042857143,0,0
Mercer,3165,Reynolds JSHS,80,51,0.6375,51,0.6375,51,0.6375,0,0,0,0
Mercer,8093,Sharon HS,114,61,0.535087719,61,0.535087719,62,0.543859649,1,0.00877193,0,0
Mercer,3124,Sharpsville Area SHS,80,52,0.65,52,0.65,55,0.6875,3,0.0375,0,0
Mercer,6129,West Middlesex Area JSHS,68,48,0.705882353,45,0.661764706,48,0.705882353,0,0,3,0.044117647
Mifflin,8187,Mifflin Co HS,361,161,0.44598338,129,0.35734072,167,0.462603878,6,0.016620499,32,0.088642659
Monroe,7866,Evergreen Community CS,13,11,0.846153846,11,0.846153846,11,0.846153846,0,0,0,0
Monroe,6935,East Stroudsburg SHS South,339,232,0.684365782,229,0.675516224,241,0.710914454,9,0.026548673,3,0.008849558
Monroe,7641,East Stroudsburg SHS North,255,156,0.611764706,155,0.607843137,170,0.666666667,14,0.054901961,1,0.003921569
Monroe,3210,Pleasant Valley HS,350,266,0.76,263,0.751428571,278,0.794285714,12,0.034285714,3,0.008571429
Monroe,3216,Pocono Mountain East HS,303,190,0.627062706,188,0.620462046,196,0.646864686,6,0.01980198,2,0.00660066
Monroe,7738,Pocono Mountain West HS,392,168,0.428571429,167,0.426020408,170,0.433673469,2,0.005102041,1,0.00255102
Monroe,3224,Stroudsburg HS,398,158,0.396984925,158,0.396984925,158,0.396984925,0,0,0,0
Montgomery,7687,Pennsylvania Virtual CS,158,45,0.284810127,45,0.284810127,56,0.35443038,11,0.069620253,0,0
Montgomery,3241,Abington SHS,603,456,0.756218905,452,0.749585406,461,0.764510779,5,0.008291874,4,0.006633499
Montgomery,3260,Cheltenham HS,327,234,0.71559633,234,0.71559633,242,0.740061162,8,0.024464832,0,0
Montgomery,3333,Plymouth-Whitemarsh SHS,361,302,0.836565097,302,0.836565097,308,0.853185596,6,0.016620499,0,0
Montgomery,3272,Hatboro-Horsham SHS,363,294,0.809917355,294,0.809917355,299,0.82369146,5,0.013774105,0,0
Montgomery,8049,Jenkintown Middle/High School,66,57,0.863636364,56,0.848484848,57,0.863636364,0,0,1,0.015151515
Montgomery,3295,Lower Merion HS,384,346,0.901041667,346,0.901041667,353,0.919270833,7,0.018229167,0,0
Montgomery,3296,Harriton SHS,280,256,0.914285714,256,0.914285714,258,0.921428571,2,0.007142857,0,0
Montgomery,4960,Lower Moreland HS,194,176,0.907216495,171,0.881443299,177,0.912371134,1,0.005154639,5,0.025773196
Montgomery,3305,Methacton HS,354,309,0.872881356,307,0.867231638,312,0.881355932,3,0.008474576,2,0.005649718
Montgomery,6729,Norristown Area HS,349,1,0.00286533,1,0.00286533,1,0.00286533,0,0,0,0
Montgomery,6998,Roosevelt Altern Sch,39,1,0.025641026,1,0.025641026,1,0.025641026,0,0,0,0
Montgomery,5345,North Penn SHS,918,727,0.791938998,725,0.789760349,728,0.793028322,1,0.001089325,2,0.002178649
Montgomery,3328,Perkiomen Valley HS,425,352,0.828235294,346,0.814117647,359,0.844705882,7,0.016470588,6,0.014117647
Montgomery,3338,Pottsgrove SHS,240,163,0.679166667,163,0.679166667,166,0.691666667,3,0.0125,0,0
Montgomery,3348,Pottstown SHS,157,58,0.369426752,58,0.369426752,70,0.445859873,12,0.076433121,0,0
Montgomery,3354,Souderton Area SHS,513,387,0.754385965,387,0.754385965,399,0.777777778,12,0.023391813,0,0
Montgomery,3376,Springfield Twp HS,184,136,0.739130435,136,0.739130435,136,0.739130435,0,0,0,0
Montgomery,3367,Spring-Ford SHS 9-12 Ctr,638,547,0.857366771,541,0.847962382,549,0.860501567,2,0.003134796,6,0.009404389
Montgomery,5078,Upper Dublin HS,328,303,0.923780488,302,0.920731707,303,0.923780488,0,0,1,0.00304878
Montgomery,3395,Upper Merion HS,259,202,0.77992278,200,0.772200772,203,0.783783784,1,0.003861004,2,0.007722008
Montgomery,3401,Upper Moreland HS,221,151,0.683257919,151,0.683257919,155,0.701357466,4,0.018099548,0,0
Montgomery,5081,Upper Perkiomen HS,240,149,0.620833333,146,0.608333333,150,0.625,1,0.004166667,3,0.0125
Montgomery,3247,Wissahickon SHS,348,301,0.864942529,301,0.864942529,301,0.864942529,0,0,0,0
Montgomery,7858,Agora Cyber CS,511,203,0.397260274,190,0.371819961,255,0.499021526,52,0.101761252,13,0.025440313
Montour,3425,Danville Area SHS,176,126,0.715909091,124,0.704545455,130,0.738636364,4,0.022727273,2,0.011363636
Northampton,7681,Lehigh Valley Academy Regional CS,94,79,0.840425532,79,0.840425532,79,0.840425532,0,0,0,0
Northampton,3434,Bangor Area HS,191,127,0.664921466,127,0.664921466,130,0.680628272,3,0.015706806,0,0
Northampton,3465,Liberty HS,569,370,0.65026362,366,0.643233743,377,0.662565905,7,0.012302285,4,0.007029877
Northampton,4957,Freedom HS,426,310,0.727699531,303,0.711267606,312,0.732394366,2,0.004694836,7,0.016431925
Northampton,7634,Lehigh Valley Charter High School for th,137,93,0.678832117,93,0.678832117,96,0.700729927,3,0.02189781,0,0
Northampton,3482,Easton Area HS,662,435,0.657099698,435,0.657099698,444,0.670694864,9,0.013595166,0,0
Northampton,3495,Nazareth Area HS,383,324,0.845953003,322,0.84073107,326,0.851174935,2,0.005221932,2,0.005221932
Northampton,3505,Northampton Area HS,445,337,0.757303371,329,0.739325843,337,0.757303371,0,0,8,0.017977528
Northampton,6439,Pen Argyl Area HS,119,87,0.731092437,85,0.714285714,90,0.756302521,3,0.025210084,2,0.016806723
Northampton,5352,Saucon Valley SHS,170,121,0.711764706,120,0.705882353,124,0.729411765,3,0.017647059,1,0.005882353
Northampton,3522,Wilson Area HS,161,112,0.695652174,110,0.683229814,115,0.714285714,3,0.01863354,2,0.01242236
Northumberland,3532,Line Mountain HS,92,48,0.52173913,48,0.52173913,52,0.565217391,4,0.043478261,0,0
Northumberland,3541,Milton HS,146,73,0.5,70,0.479452055,75,0.51369863,2,0.01369863,3,0.020547945
Northumberland,6936,Mount Carmel Area HS,81,40,0.49382716,39,0.481481481,42,0.518518519,2,0.024691358,1,0.012345679
Northumberland,7893,Shamokin Area HS,150,73,0.486666667,73,0.486666667,74,0.493333333,1,0.006666667,0,0
Northumberland,3569,Shikellamy HS,176,85,0.482954545,81,0.460227273,86,0.488636364,1,0.005681818,4,0.022727273
Northumberland,5103,Warrior Run HS,127,61,0.480314961,61,0.480314961,62,0.488188976,1,0.007874016,0,0
Perry,6341,Greenwood HS,54,38,0.703703704,38,0.703703704,38,0.703703704,0,0,0,0
Perry,7930,Newport HS,71,44,0.61971831,38,0.535211268,45,0.633802817,1,0.014084507,6,0.084507042
Perry,3589,Susquenita HS,100,45,0.45,45,0.45,45,0.45,0,0,0,0
Perry,3596,West Perry SHS,145,74,0.510344828,73,0.503448276,77,0.531034483,3,0.020689655,1,0.006896552
Philadelphia,7744,First Philadelphia Preparatory CS,96,57,0.59375,57,0.59375,65,0.677083333,8,0.083333333,0,0
Philadelphia,8083,Sankofa Freedom Academy CS,40,35,0.875,35,0.875,38,0.95,3,0.075,0,0
Philadelphia,7678,Mastery CHS-Lenfest Campus,80,60,0.75,55,0.6875,64,0.8,4,0.05,5,0.0625
Philadelphia,7685,People for People CS,25,20,0.8,20,0.8,22,0.88,2,0.08,0,0
Philadelphia,7737,Philadelphia Electrical & Tech CHS,120,67,0.558333333,67,0.558333333,81,0.675,14,0.116666667,0,0
Philadelphia,7750,Belmont CS,70,0,0,0,0,0,0,0,0,0,0
Philadelphia,7777,Maritime Academy CS,56,32,0.571428571,32,0.571428571,32,0.571428571,0,0,0,0
Philadelphia,7909,Mastery CS -Shoemaker Campus,117,86,0.735042735,84,0.717948718,99,0.846153846,13,0.111111111,2,0.017094017
Philadelphia,7910,Mastery CS - Thomas Campus,106,58,0.547169811,58,0.547169811,71,0.669811321,13,0.122641509,0,0
Philadelphia,8359,TECH Freire CS,99,63,0.636363636,62,0.626262626,72,0.727272727,9,0.090909091,1,0.01010101
Philadelphia,8216,Esperanza Cyber CS,44,18,0.409090909,18,0.409090909,20,0.454545455,2,0.045454545,0,0
Philadelphia,7510,Community Academy of Philadelphia CS,136,82,0.602941176,82,0.602941176,83,0.610294118,1,0.007352941,0,0
Philadelphia,7513,Youth Build Phila CS,144,20,0.138888889,20,0.138888889,23,0.159722222,3,0.020833333,0,0
Philadelphia,7540,Preparatory CS of Mathematics Science Te,121,61,0.504132231,61,0.504132231,66,0.545454545,5,0.041322314,0,0
Philadelphia,7542,Imhotep Institute CHS,123,94,0.764227642,93,0.756097561,99,0.804878049,5,0.040650407,1,0.008130081
Philadelphia,7546,Multicultural Academy CS,49,39,0.795918367,39,0.795918367,42,0.857142857,3,0.06122449,0,0
Philadelphia,7574,MAST Community CS,104,89,0.855769231,87,0.836538462,93,0.894230769,4,0.038461538,2,0.019230769
Philadelphia,7582,Math Civics and Sciences CS,78,66,0.846153846,66,0.846153846,76,0.974358974,10,0.128205128,0,0
Philadelphia,7586,Freire CS,101,71,0.702970297,71,0.702970297,79,0.782178218,8,0.079207921,0,0
Philadelphia,7587,Philadelphia Academy CS,90,56,0.622222222,56,0.622222222,56,0.622222222,0,0,0,0
Philadelphia,7588,Mastery CS-Hardy Williams,105,65,0.619047619,64,0.60952381,67,0.638095238,2,0.019047619,1,0.00952381
Philadelphia,7647,Philadelphia Performing Arts CS,151,131,0.867549669,131,0.867549669,131,0.867549669,0,0,0,0
Philadelphia,7649,New Foundations CS,181,121,0.668508287,118,0.651933702,127,0.701657459,6,0.033149171,3,0.016574586
Philadelphia,7665,Esperanza Academy CS,179,109,0.608938547,109,0.608938547,127,0.709497207,18,0.100558659,0,0
Philadelphia,7666,Franklin Towne CHS,267,193,0.722846442,191,0.715355805,200,0.74906367,7,0.026217228,2,0.007490637
Philadelphia,8205,Olney Charter High School,412,156,0.378640777,156,0.378640777,179,0.434466019,23,0.055825243,0,0
Philadelphia,7672,Mariana Bracetti Academy CS,95,56,0.589473684,56,0.589473684,64,0.673684211,8,0.084210526,0,0
Philadelphia,8207,Mastery CS-Gratz Campus,222,111,0.5,109,0.490990991,142,0.63963964,31,0.13963964,2,0.009009009
Philadelphia,8358,KIPP DuBois CS,129,100,0.775193798,94,0.728682171,112,0.868217054,12,0.093023256,6,0.046511628
Philadelphia,3728,Widener Memorial Sch,3,0,0,0,0,0,0,0,0,0,0
Philadelphia,3808,Masterman Julia R Sec Sch,113,103,0.911504425,103,0.911504425,103,0.911504425,0,0,0,0
Philadelphia,3816,Fels Samuel HS,176,86,0.488636364,74,0.420454545,95,0.539772727,9,0.051136364,12,0.068181818
Philadelphia,3818,Furness Horace HS,118,45,0.381355932,38,0.322033898,47,0.398305085,2,0.016949153,7,0.059322034
Philadelphia,3841,Dobbins AVT HS,87,48,0.551724138,43,0.494252874,51,0.586206897,3,0.034482759,5,0.057471264
Philadelphia,3842,Mastbaum Jules E AVTS,108,23,0.212962963,18,0.166666667,25,0.231481481,2,0.018518519,5,0.046296296
Philadelphia,3843,Girls HS,186,143,0.768817204,139,0.747311828,148,0.795698925,5,0.02688172,4,0.021505376
Philadelphia,3844,Roxborough HS,127,45,0.354330709,35,0.275590551,49,0.385826772,4,0.031496063,10,0.078740157
Philadelphia,3845,Lincoln HS,306,162,0.529411765,149,0.486928105,179,0.58496732,17,0.055555556,13,0.04248366
Philadelphia,3847,Bartram John - Main,106,51,0.481132075,45,0.424528302,54,0.509433962,3,0.028301887,6,0.056603774
Philadelphia,3848,Central HS,607,414,0.682042834,412,0.678747941,420,0.691927512,6,0.009884679,2,0.003294893
Philadelphia,3849,Edison HS/Fareira Skills,176,40,0.227272727,31,0.176136364,42,0.238636364,2,0.011363636,9,0.051136364
Philadelphia,3850,Frankford HS,148,70,0.472972973,61,0.412162162,79,0.533783784,9,0.060810811,9,0.060810811
Philadelphia,3851,Franklin Benjamin HS,53,24,0.452830189,21,0.396226415,26,0.490566038,2,0.037735849,3,0.056603774
Philadelphia,3855,Northeast HS,634,376,0.593059937,347,0.547318612,386,0.608832808,10,0.015772871,29,0.045741325
Philadelphia,3857,Overbrook HS,103,54,0.524271845,44,0.427184466,58,0.563106796,4,0.038834951,10,0.097087379
Philadelphia,3859,South Philadelphia HS,107,31,0.289719626,26,0.242990654,36,0.336448598,5,0.046728972,5,0.046728972
Philadelphia,3860,West Philadelphia HS,81,32,0.395061728,28,0.345679012,35,0.432098765,3,0.037037037,4,0.049382716
Philadelphia,3861,Saul W B Agricultural School,112,65,0.580357143,58,0.517857143,74,0.660714286,9,0.080357143,7,0.0625
Philadelphia,6527,Washington George HS,229,88,0.384279476,84,0.366812227,90,0.3930131,2,0.008733624,4,0.017467249
Philadelphia,6548,Parkway Northwest,58,20,0.344827586,19,0.327586207,21,0.362068966,1,0.017241379,1,0.017241379
Philadelphia,6675,King Martin Luther HS,98,49,0.5,42,0.428571429,57,0.581632653,8,0.081632653,7,0.071428571
Philadelphia,6822,Franklin LC,172,124,0.720930233,116,0.674418605,131,0.761627907,7,0.040697674,8,0.046511628
Philadelphia,6996,Creative and Performing Arts,164,80,0.487804878,78,0.475609756,82,0.5,2,0.012195122,2,0.012195122
Philadelphia,7023,Carver HS,192,56,0.291666667,56,0.291666667,57,0.296875,1,0.005208333,0,0
Philadelphia,7070,Bodine William W HS,124,69,0.556451613,65,0.524193548,71,0.572580645,2,0.016129032,4,0.032258065
Philadelphia,7072,Swenson Arts & Technology HS,151,95,0.629139073,87,0.57615894,107,0.708609272,12,0.079470199,8,0.052980132
Philadelphia,7229,Hill Freedman World Academy,92,36,0.391304348,35,0.380434783,37,0.402173913,1,0.010869565,1,0.010869565
Philadelphia,7245,Sayre William L MS,75,16,0.213333333,14,0.186666667,19,0.253333333,3,0.04,2,0.026666667
Philadelphia,7255,Strawberry Mansion HS,33,19,0.575757576,17,0.515151515,21,0.636363636,2,0.060606061,2,0.060606061
Philadelphia,7664,Gamp,56,41,0.732142857,39,0.696428571,42,0.75,1,0.017857143,2,0.035714286
Philadelphia,7780,Paul Robeson HS for Human Services,70,43,0.614285714,42,0.6,44,0.628571429,1,0.014285714,1,0.014285714
Philadelphia,7782,Parkway Center City Middle College,94,75,0.79787234,72,0.765957447,78,0.829787234,3,0.031914894,3,0.031914894
Philadelphia,7808,Parkway West,71,51,0.718309859,47,0.661971831,54,0.76056338,3,0.042253521,4,0.056338028
Philadelphia,7811,Lankenau HS,57,45,0.789473684,40,0.701754386,46,0.807017544,1,0.01754386,5,0.087719298
Philadelphia,7813,Randolph A. Philip AVT HS,69,40,0.579710145,29,0.420289855,44,0.637681159,4,0.057971014,11,0.15942029
Philadelphia,7815,Motivation HS,71,41,0.577464789,39,0.549295775,43,0.605633803,2,0.028169014,2,0.028169014
Philadelphia,7850,Philadelphia Military Acad at Elverson,72,38,0.527777778,32,0.444444444,41,0.569444444,3,0.041666667,6,0.083333333
Philadelphia,7852,Kensington Creative & Performing Arts HS,106,27,0.254716981,25,0.235849057,28,0.264150943,1,0.009433962,2,0.018867925
Philadelphia,7855,Kensington Health Sciences,104,44,0.423076923,42,0.403846154,46,0.442307692,2,0.019230769,2,0.019230769
Philadelphia,7903,School of the Future,100,49,0.49,47,0.47,51,0.51,2,0.02,2,0.02
Philadelphia,7904,Academy at Palumbo,249,205,0.823293173,201,0.807228916,207,0.831325301,2,0.008032129,4,0.016064257
Philadelphia,7905,Constitution HS,105,73,0.695238095,70,0.666666667,78,0.742857143,5,0.047619048,3,0.028571429
Philadelphia,7906,Science Leadership Academy,124,103,0.830645161,100,0.806451613,106,0.85483871,3,0.024193548,3,0.024193548
Philadelphia,8039,Arts Academy at Benjamin Rush,160,127,0.79375,123,0.76875,131,0.81875,4,0.025,4,0.025
Philadelphia,8293,Penn Treaty Sch,72,36,0.5,33,0.458333333,41,0.569444444,5,0.069444444,3,0.041666667
Philadelphia,8328,The Workshop School,45,22,0.488888889,19,0.422222222,22,0.488888889,0,0,3,0.066666667
Philadelphia,8329,The U School: Innovative Lab,43,19,0.441860465,16,0.372093023,19,0.441860465,0,0,3,0.069767442
Philadelphia,8330,The Science Leadership Academy at Beeber,125,74,0.592,72,0.576,75,0.6,1,0.008,2,0.016
Philadelphia,8331,The Linc,37,6,0.162162162,6,0.162162162,6,0.162162162,0,0,0,0
Philadelphia,8332,Building 21,50,32,0.64,28,0.56,35,0.7,3,0.06,4,0.08
Philadelphia,8385,Philadelphia Learning Academy - North,9,3,0.333333333,3,0.333333333,4,0.444444444,1,0.111111111,0,0
Philadelphia,8386,Philadelphia Learning Academy - South,6,3,0.5,3,0.5,4,0.666666667,1,0.166666667,0,0
Philadelphia,8388,Kensington HS,79,24,0.303797468,21,0.265822785,26,0.329113924,2,0.025316456,3,0.037974684
Philadelphia,8440,Vaux HS: A Big Picture School,91,55,0.604395604,47,0.516483516,57,0.626373626,2,0.021978022,8,0.087912088
Philadelphia,8195,Universal Audenried CS,104,25,0.240384615,25,0.240384615,25,0.240384615,0,0,0,0
Philadelphia,7961,Mastery CS-Pickett Campus,106,74,0.698113208,72,0.679245283,75,0.70754717,1,0.009433962,2,0.018867925
Philadelphia,8148,ASPIRA Bilingual Cyber CS,54,17,0.314814815,17,0.314814815,20,0.37037037,3,0.055555556,0,0
Philadelphia,7981,Boys Latin of Philadelphia CS,74,53,0.716216216,53,0.716216216,55,0.743243243,2,0.027027027,0,0
Philadelphia,8126,Tacony Academy CS,69,34,0.492753623,30,0.434782609,39,0.565217391,5,0.072463768,4,0.057971014
Pike,4310,Wallenpaupack Area HS,238,114,0.478991597,114,0.478991597,121,0.508403361,7,0.029411765,0,0
Pike,5261,Delaware Valley HS,383,267,0.697127937,267,0.697127937,274,0.7154047,7,0.018276762,0,0
Potter,6222,Austin Area JSHS,14,7,0.5,7,0.5,7,0.5,0,0,0,0
Potter,3869,Coudersport Area JSHS,57,33,0.578947368,32,0.561403509,36,0.631578947,3,0.052631579,1,0.01754386
Potter,6223,Galeton Area Sch,23,7,0.304347826,7,0.304347826,11,0.47826087,4,0.173913043,0,0
Potter,3875,Northern Potter JSHS,30,4,0.133333333,4,0.133333333,4,0.133333333,0,0,0,0
Potter,3877,Oswayo Valley HS,22,11,0.5,11,0.5,11,0.5,0,0,0,0
Schuylkill,3891,Blue Mountain HS,227,138,0.607929515,138,0.607929515,141,0.621145374,3,0.013215859,0,0
Schuylkill,8403,Mahanoy Area JSHS,69,42,0.608695652,42,0.608695652,44,0.637681159,2,0.028985507,0,0
Schuylkill,6583,Minersville Area JSHS,68,37,0.544117647,36,0.529411765,37,0.544117647,0,0,1,0.014705882
Schuylkill,8161,Gillingham Charter School,11,1,0.090909091,1,0.090909091,1,0.090909091,0,0,0,0
Schuylkill,3883,North Schuylkill JSHS,134,78,0.582089552,78,0.582089552,80,0.597014925,2,0.014925373,0,0
Schuylkill,3910,Pine Grove Area HS,134,58,0.432835821,58,0.432835821,58,0.432835821,0,0,0,0
Schuylkill,3924,Pottsville Area HS,211,112,0.530805687,104,0.492890995,118,0.559241706,6,0.028436019,8,0.037914692
Schuylkill,3940,Shenandoah Valley JSHS,71,32,0.450704225,32,0.450704225,33,0.464788732,1,0.014084507,0,0
Schuylkill,5264,Schuylkill Haven SHS,75,41,0.546666667,41,0.546666667,42,0.56,1,0.013333333,0,0
Schuylkill,5070,Tamaqua Area SHS,163,130,0.797546012,126,0.773006135,130,0.797546012,0,0,4,0.024539877
Schuylkill,3957,Tri-Valley JSHS,62,33,0.532258065,27,0.435483871,34,0.548387097,1,0.016129032,6,0.096774194
Schuylkill,3914,Williams Valley JSHS,77,37,0.480519481,36,0.467532468,39,0.506493506,2,0.025974026,1,0.012987013
Snyder,3962,Midd-West HS,154,44,0.285714286,44,0.285714286,44,0.285714286,0,0,0,0
Snyder,3969,Selinsgrove Area HS,191,118,0.617801047,118,0.617801047,121,0.633507853,3,0.015706806,0,0
Somerset,6207,Berlin Brothersvalley SHS,71,40,0.563380282,39,0.549295775,40,0.563380282,0,0,1,0.014084507
Somerset,3978,Conemaugh Twp Area MS/SHS,64,39,0.609375,39,0.609375,41,0.640625,2,0.03125,0,0
Somerset,3988,North Star HS,75,34,0.453333333,34,0.453333333,36,0.48,2,0.026666667,0,0
Somerset,6210,Rockwood Area JSHS,54,34,0.62962963,29,0.537037037,35,0.648148148,1,0.018518519,5,0.092592593
Somerset,4002,Salisbury-Elk Lick JSHS,13,6,0.461538462,6,0.461538462,6,0.461538462,0,0,0,0
Somerset,4006,Shade JSHS,31,18,0.580645161,17,0.548387097,18,0.580645161,0,0,1,0.032258065
Somerset,6800,Shanksville-Stonycreek HS,18,11,0.611111111,11,0.611111111,12,0.666666667,1,0.055555556,0,0
Somerset,8274,Somerset Area Jr-Sr HS,157,77,0.49044586,75,0.477707006,81,0.515923567,4,0.025477707,2,0.012738854
Somerset,6216,Turkeyfoot Valley Area JSHS,30,15,0.5,14,0.466666667,15,0.5,0,0,1,0.033333333
Somerset,4026,Windber Area HS,80,44,0.55,41,0.5125,45,0.5625,1,0.0125,3,0.0375
Sullivan,4030,Sullivan Co JSHS,46,28,0.608695652,28,0.608695652,30,0.652173913,2,0.043478261,0,0
Susquehanna,4034,Blue Ridge HS,71,46,0.647887324,44,0.61971831,46,0.647887324,0,0,2,0.028169014
Susquehanna,6418,Elk Lake JSHS,70,27,0.385714286,25,0.357142857,30,0.428571429,3,0.042857143,2,0.028571429
Susquehanna,6419,Forest City Regional HS,51,28,0.549019608,28,0.549019608,30,0.588235294,2,0.039215686,0,0
Susquehanna,4044,Montrose Area JSHS,97,52,0.536082474,47,0.484536082,54,0.556701031,2,0.020618557,5,0.051546392
Susquehanna,4049,Mountain View JSHS,57,36,0.631578947,34,0.596491228,37,0.649122807,1,0.01754386,2,0.035087719
Susquehanna,4054,Susquehanna Community JSHS,41,22,0.536585366,22,0.536585366,22,0.536585366,0,0,0,0
Tioga,4058,Cowanesque Valley JSHS,55,20,0.363636364,19,0.345454545,22,0.4,2,0.036363636,1,0.018181818
Tioga,6373,Williamson SHS,86,40,0.465116279,39,0.453488372,41,0.476744186,1,0.011627907,1,0.011627907
Tioga,4064,North Penn-Liberty JSHS,47,22,0.468085106,20,0.425531915,24,0.510638298,2,0.042553191,2,0.042553191
Tioga,4068,North Penn-Mansfield JSHS,86,39,0.453488372,38,0.441860465,40,0.465116279,1,0.011627907,1,0.011627907
Tioga,4080,Wellsboro Area HS,107,54,0.504672897,52,0.485981308,55,0.514018692,1,0.009345794,2,0.018691589
Union,4085,Lewisburg HS,151,117,0.774834437,117,0.774834437,117,0.774834437,0,0,0,0
Union,4091,Mifflinburg Area SHS,154,67,0.435064935,67,0.435064935,73,0.474025974,6,0.038961039,0,0
Venango,4098,Cranberry Area JSHS,75,39,0.52,28,0.373333333,39,0.52,0,0,11,0.146666667
Venango,4106,Franklin Area JSHS,106,62,0.58490566,60,0.566037736,65,0.613207547,3,0.028301887,2,0.018867925
Venango,4931,Oil City SHS,166,68,0.409638554,66,0.397590361,72,0.43373494,4,0.024096386,2,0.012048193
Venango,1668,Titusville SHS,98,46,0.469387755,43,0.43877551,55,0.56122449,9,0.091836735,3,0.030612245
Venango,4126,Rocky Grove JSHS,61,25,0.409836066,18,0.295081967,29,0.475409836,4,0.06557377,7,0.114754098
Warren,7833,Tidioute Community CS,17,12,0.705882353,11,0.647058824,12,0.705882353,0,0,1,0.058823529
Warren,4135,Youngsville MS/HS,70,41,0.585714286,36,0.514285714,42,0.6,1,0.014285714,5,0.071428571
Warren,4143,Eisenhower M/HS,66,37,0.560606061,34,0.515151515,39,0.590909091,2,0.03030303,3,0.045454545
Warren,4146,Sheffield M/HS,42,24,0.571428571,21,0.5,26,0.619047619,2,0.047619048,3,0.071428571
Warren,4149,Warren Area HS,162,92,0.567901235,90,0.555555556,99,0.611111111,7,0.043209877,2,0.012345679
Washington,4165,Avella Area JSHS,47,31,0.659574468,31,0.659574468,31,0.659574468,0,0,0,0
Washington,4188,Bentworth SHS,86,54,0.627906977,49,0.569767442,56,0.651162791,2,0.023255814,5,0.058139535
Washington,4181,Bethlehem-Center SHS,81,52,0.641975309,39,0.481481481,52,0.641975309,0,0,13,0.160493827
Washington,4195,Burgettstown MS/HS,72,34,0.472222222,34,0.472222222,34,0.472222222,0,0,0,0
Washington,4203,California Area SHS,61,35,0.573770492,35,0.573770492,36,0.590163934,1,0.016393443,0,0
Washington,4217,Canon-McMillan SHS,425,285,0.670588235,275,0.647058824,287,0.675294118,2,0.004705882,10,0.023529412
Washington,4715,Charleroi Area HS,93,59,0.634408602,58,0.623655914,59,0.634408602,0,0,1,0.010752688
Washington,4235,Chartiers-Houston JSHS,85,61,0.717647059,55,0.647058824,65,0.764705882,4,0.047058824,6,0.070588235
Washington,4242,Fort Cherry JSHS,78,49,0.628205128,49,0.628205128,52,0.666666667,3,0.038461538,0,0
Washington,4249,McGuffey HS,105,70,0.666666667,70,0.666666667,76,0.723809524,6,0.057142857,0,0
Washington,5083,Peters Twp HS,363,307,0.845730028,303,0.834710744,307,0.845730028,0,0,4,0.011019284
Washington,7019,Ringgold SHS,195,90,0.461538462,87,0.446153846,98,0.502564103,8,0.041025641,3,0.015384615
Washington,6012,Trinity SHS,253,158,0.624505929,156,0.616600791,162,0.640316206,4,0.015810277,2,0.007905138
Washington,4286,Washington HS,83,39,0.469879518,34,0.409638554,40,0.481927711,1,0.012048193,5,0.060240964
Washington,6704,Western Wayne HS,127,79,0.622047244,77,0.606299213,83,0.653543307,4,0.031496063,2,0.015748031
Westmoreland,4930,Belle Vernon Area HS,181,129,0.712707182,124,0.685082873,129,0.712707182,0,0,5,0.027624309
Westmoreland,4340,Burrell HS,144,107,0.743055556,106,0.736111111,108,0.75,1,0.006944444,1,0.006944444
Westmoreland,4352,Derry Area SHS,137,89,0.649635036,89,0.649635036,93,0.678832117,4,0.02919708,0,0
Westmoreland,4360,Franklin Regional SHS,282,232,0.822695035,230,0.815602837,234,0.829787234,2,0.007092199,2,0.007092199
Westmoreland,7550,Dr Robert Ketterer CS Inc,31,0,0,0,0,0,0,0,0,0,0
Westmoreland,4845,Greater Latrobe SHS,319,221,0.692789969,217,0.680250784,222,0.695924765,1,0.003134796,4,0.012539185
Westmoreland,4373,Greensburg-Salem HS,172,124,0.720930233,118,0.686046512,124,0.720930233,0,0,6,0.034883721
Westmoreland,4404,Hempfield Area SHS,428,209,0.488317757,201,0.469626168,212,0.495327103,3,0.007009346,8,0.018691589
Westmoreland,8421,Jeannette HS,58,35,0.603448276,31,0.534482759,35,0.603448276,0,0,4,0.068965517
Westmoreland,4431,Kiski Area HS,258,139,0.53875969,134,0.519379845,142,0.550387597,3,0.011627907,5,0.019379845
Westmoreland,4442,Ligonier Valley HS,104,73,0.701923077,73,0.701923077,76,0.730769231,3,0.028846154,0,0
Westmoreland,6181,Monessen SHS,60,36,0.6,29,0.483333333,36,0.6,0,0,7,0.116666667
Westmoreland,4458,Mount Pleasant Area HS,142,99,0.697183099,92,0.647887324,100,0.704225352,1,0.007042254,7,0.049295775
Westmoreland,8323,Valley JSHS,99,41,0.414141414,41,0.414141414,44,0.444444444,3,0.03030303,0,0
Westmoreland,4717,Norwin SHS,408,315,0.772058824,302,0.740196078,324,0.794117647,9,0.022058824,13,0.031862745
Westmoreland,6648,Penn Trafford HS,326,250,0.766871166,248,0.760736196,252,0.773006135,2,0.006134969,2,0.006134969
Westmoreland,6191,Southmoreland SHS,123,71,0.577235772,71,0.577235772,71,0.577235772,0,0,0,0
Westmoreland,4735,Yough SHS,146,89,0.609589041,84,0.575342466,89,0.609589041,0,0,5,0.034246575
Wyoming,5271,Tunkhannock HS,160,96,0.6,91,0.56875,96,0.6,0,0,5,0.03125
Wyoming,4528,Lackawanna Trail JSHS,70,44,0.628571429,44,0.628571429,47,0.671428571,3,0.042857143,0,0
York,4545,Central York HS,423,298,0.704491726,293,0.692671395,305,0.721040189,7,0.016548463,5,0.011820331
York,4553,Dallastown Area SHS,455,308,0.676923077,303,0.665934066,320,0.703296703,12,0.026373626,5,0.010989011
York,4558,Dover Area HS,227,128,0.563876652,126,0.555066079,128,0.563876652,0,0,2,0.008810573
York,4564,Eastern York HS,156,79,0.506410256,75,0.480769231,92,0.58974359,13,0.083333333,4,0.025641026
York,4571,Hanover SHS,110,54,0.490909091,48,0.436363636,54,0.490909091,0,0,6,0.054545455
York,7624,Crispus Attucks CS,32,0,0,0,0,0,0,0,0,0,0
York,4577,Northeastern SHS,268,179,0.667910448,165,0.615671642,187,0.697761194,8,0.029850746,14,0.052238806
York,4598,Red Lion Area SHS,326,193,0.59202454,182,0.558282209,199,0.610429448,6,0.018404908,11,0.033742331
York,4602,Kennard-Dale HS,169,109,0.644970414,105,0.621301775,111,0.656804734,2,0.01183432,4,0.023668639
York,4608,South Western SHS,282,162,0.574468085,159,0.563829787,176,0.624113475,14,0.04964539,3,0.010638298
York,4614,Susquehannock HS,224,156,0.696428571,147,0.65625,156,0.696428571,0,0,9,0.040178571
York,4623,Spring Grove Area HS,268,160,0.597014925,148,0.552238806,168,0.626865672,8,0.029850746,12,0.044776119
York,6705,West York Area HS,186,114,0.612903226,103,0.553763441,121,0.650537634,7,0.037634409,11,0.059139785
York,4647,William Penn SHS,228,70,0.307017544,67,0.293859649,75,0.328947368,5,0.021929825,3,0.013157895
York,5168,York Co School of Technology,387,120,0.310077519,110,0.284237726,123,0.317829457,3,0.007751938,10,0.025839793
York,4658,York Suburban SHS,200,145,0.725,145,0.725,147,0.735,2,0.01,0,0
York,1732,Cedar Cliff HS,301,190,0.631229236,189,0.627906977,195,0.647840532,5,0.016611296,1,0.003322259
York,4704,Red Land SHS,250,155,0.62,152,0.608,156,0.624,1,0.004,3,0.012
York,6345,Northern HS,259,154,0.594594595,154,0.594594595,157,0.606177606,3,0.011583012,0,0
Total,9999,All,"14,956","9,218",0.567843562,"8,964",0.549124907,"9,540",0.594110679,322,0.026267117,254,0.018718655